
    {
        "tileMap": [
            [1,1,1,1,1,16,20,18,1,1,1,1,1,1,1,1,1],
            [1,1,1,1,1,16,20,18,1,1,1,1,1,1,1,1,1],
            [1,1,1,1,1,16,20,18,1,1,1,1,1,1,1,1,1],
            [1,1,1,1,11,21,22,23,1,1,1,1,1,1,1,1,1],
            [1,1,1,1,16,20,18,1,1,1,1,1,1,1,1,1,1],
            [1,1,1,1,16,20,18,1,1,1,1,1,1,1,1,1,1],
            [1,1,1,11,21,22,23,1,1,1,1,1,1,1,1,1,1],
            [1,1,1,16,20,18,1,1,1,1,1,1,1,1,1,1,1],
            [1,1,1,16,20,18,1,1,1,1,1,1,1,1,1,1,1]
        ],

        "colissionMap": [
            [0,7,8,0,0,0,0,0,0,0,0,0,0,0,0,0,0],
            [0,10,9,0,0,0,0,0,0,0,0,26,25,25,27,0,0],
            [0,0,0,0,0,0,0,0,0,0,0,24,0,30,24,0,0],
            [0,0,0,0,0,0,0,0,0,0,0,24,0,3,24,4,0],
            [0,0,0,0,0,0,0,0,0,0,0,24,0,30,24,0,0],
            [0,0,0,0,0,0,0,0,0,0,0,29,0,25,28,0,0],
            [0,0,0,0,0,0,0,0,0,0,0,0,0,5,6,0,0],
            [0,0,0,0,0,0,0,0,0,0,0,0,0,0,31,35,35],
            [0,0,0,0,0,0,0,0,0,0,0,0,0,0,34,33,33]
        ],

        "tileSet": "whatever",

        "dimensions": {
            "width": 1280,
            "height": 720
        }
    }
